"","week","date","state","pos_test","neg_test","test"
"1",10,2020-03-03,"Alabama",0,0,0
"2",11,2020-03-10,"Alabama",28,28,56
"3",12,2020-03-17,"Alabama",139,1637,1776
"4",13,2020-03-24,"Alabama",692,4029,4721
"5",14,2020-03-31,"Alabama",1109,7103,8212
"6",15,2020-04-07,"Alabama",1766,12651,14417
"7",16,2020-04-14,"Alabama",1291,15427,16718
"8",17,2020-04-21,"Alabama",1474,26623,28097
"9",18,2020-04-28,"Alabama",1526,27594,29120
"10",19,2020-05-05,"Alabama",1984,24343,26327
"11",20,2020-05-12,"Alabama",2077,25602,27679
"12",21,2020-05-19,"Alabama",2644,30548,33192
"13",22,2020-05-26,"Alabama",666,2778,3444
"14",10,2020-03-03,"Alaska",0,23,23
"15",11,2020-03-10,"Alaska",1,120,121
"16",12,2020-03-17,"Alaska",21,803,824
"17",13,2020-03-24,"Alaska",92,2594,2686
"18",14,2020-03-31,"Alaska",77,3152,3229
"19",15,2020-04-07,"Alaska",86,861,947
"20",16,2020-04-14,"Alaska",44,2250,2294
"21",17,2020-04-21,"Alaska",24,6108,6132
"22",18,2020-04-28,"Alaska",25,5442,5467
"23",19,2020-05-05,"Alaska",11,6946,6957
"24",20,2020-05-12,"Alaska",18,6913,6931
"25",21,2020-05-19,"Alaska",10,8851,8861
"26",22,2020-05-26,"Alaska",2,490,492
"27",12,2020-03-17,"American Samoa",0,0,0
"28",13,2020-03-24,"American Samoa",0,0,0
"29",14,2020-03-31,"American Samoa",0,3,3
"30",15,2020-04-07,"American Samoa",0,0,0
"31",16,2020-04-14,"American Samoa",0,0,0
"32",17,2020-04-21,"American Samoa",0,0,0
"33",18,2020-04-28,"American Samoa",0,80,80
"34",19,2020-05-05,"American Samoa",0,22,22
"35",20,2020-05-12,"American Samoa",0,0,0
"36",21,2020-05-19,"American Samoa",0,19,19
"37",22,2020-05-26,"American Samoa",0,0,0
"38",10,2020-03-03,"Arizona",5,44,49
"39",11,2020-03-10,"Arizona",13,81,94
"40",12,2020-03-17,"Arizona",247,184,431
"41",13,2020-03-24,"Arizona",892,15293,16185
"42",14,2020-03-31,"Arizona",1299,14476,15775
"43",15,2020-04-07,"Arizona",1246,9567,10813
"44",16,2020-04-14,"Arizona",1362,9791,11153
"45",17,2020-04-21,"Arizona",1652,10391,12043
"46",18,2020-04-28,"Arizona",2203,16507,18710
"47",19,2020-05-05,"Arizona",2461,28750,31211
"48",20,2020-05-12,"Arizona",2790,37219,40009
"49",21,2020-05-19,"Arizona",2391,28918,31309
"50",22,2020-05-26,"Arizona",222,2727,2949
"51",10,2020-03-03,"Arkansas",0,12,12
"52",11,2020-03-10,"Arkansas",22,120,142
"53",12,2020-03-17,"Arkansas",152,774,926
"54",13,2020-03-24,"Arkansas",299,4356,4655
"55",14,2020-03-31,"Arkansas",402,6708,7110
"56",15,2020-04-07,"Arkansas",535,7424,7959
"57",16,2020-04-14,"Arkansas",513,5236,5749
"58",17,2020-04-21,"Arkansas",1094,12810,13904
"59",18,2020-04-28,"Arkansas",441,13544,13985
"60",19,2020-05-05,"Arkansas",576,14012,14588
"61",20,2020-05-12,"Arkansas",779,15430,16209
"62",21,2020-05-19,"Arkansas",1216,25167,26383
"63",22,2020-05-26,"Arkansas",151,0,151
"64",10,2020-03-03,"California",114,690,804
"65",11,2020-03-10,"California",221,7291,7512
"66",12,2020-03-17,"California",1398,4586,5984
"67",13,2020-03-24,"California",4714,7982,12696
"68",14,2020-03-31,"California",7889,82546,90435
"69",15,2020-04-07,"California",8012,65439,73451
"70",16,2020-04-14,"California",8630,90988,99618
"71",17,2020-04-21,"California",12486,250423,262909
"72",18,2020-04-28,"California",11473,182992,194465
"73",19,2020-05-05,"California",13002,231021,244023
"74",20,2020-05-12,"California",12491,288284,300775
"75",21,2020-05-19,"California",14128,337302,351430
"76",22,2020-05-26,"California",2175,50119,52294
"77",10,2020-03-03,"Colorado",9,133,142
"78",11,2020-03-10,"Colorado",122,494,616
"79",12,2020-03-17,"Colorado",460,4218,4678
"80",13,2020-03-24,"Colorado",2036,7892,9928
"81",14,2020-03-31,"Colorado",2323,8086,10409
"82",15,2020-04-07,"Colorado",2734,9027,11761
"83",16,2020-04-14,"Colorado",2046,6615,8661
"84",17,2020-04-21,"Colorado",3711,13368,17079
"85",18,2020-04-28,"Colorado",3194,16622,19816
"86",19,2020-05-05,"Colorado",3264,22436,25700
"87",20,2020-05-12,"Colorado",2039,17666,19705
"88",21,2020-05-19,"Colorado",2236,19577,21813
"89",22,2020-05-26,"Colorado",95,5608,5703
"90",10,2020-03-03,"Connecticut",1,46,47
"91",11,2020-03-10,"Connecticut",25,79,104
"92",12,2020-03-17,"Connecticut",389,3960,4349
"93",13,2020-03-24,"Connecticut",2156,7944,10100
"94",14,2020-03-31,"Connecticut",4335,7751,12086
"95",15,2020-04-07,"Connecticut",6475,11148,17623
"96",16,2020-04-14,"Connecticut",6434,12063,18497
"97",17,2020-04-21,"Connecticut",5454,11551,17005
"98",18,2020-04-28,"Connecticut",4018,18664,22682
"99",19,2020-05-05,"Connecticut",4478,25537,30015
"100",20,2020-05-12,"Connecticut",4351,40820,45171
"101",21,2020-05-19,"Connecticut",2757,41290,44047
"102",22,2020-05-26,"Connecticut",430,3206,3636
"103",10,2020-03-03,"Delaware",0,15,15
"104",11,2020-03-10,"Delaware",8,21,29
"105",12,2020-03-17,"Delaware",60,0,60
"106",13,2020-03-24,"Delaware",196,2180,2376
"107",14,2020-03-31,"Delaware",409,4105,4514
"108",15,2020-04-07,"Delaware",952,3874,4826
"109",16,2020-04-14,"Delaware",1120,2313,3433
"110",17,2020-04-21,"Delaware",1417,2946,4363
"111",18,2020-04-28,"Delaware",1126,3368,4494
"112",19,2020-05-05,"Delaware",1277,6541,7818
"113",20,2020-05-12,"Delaware",1304,9226,10530
"114",21,2020-05-19,"Delaware",1096,10342,11438
"115",22,2020-05-26,"Delaware",101,917,1018
"116",10,2020-03-03,"District of Columbia",1,14,15
"117",11,2020-03-10,"District of Columbia",16,82,98
"118",12,2020-03-17,"District of Columbia",99,1017,1116
"119",13,2020-03-24,"District of Columbia",285,1569,1854
"120",14,2020-03-31,"District of Columbia",696,3674,4370
"121",15,2020-04-07,"District of Columbia",858,2623,3481
"122",16,2020-04-14,"District of Columbia",972,2207,3179
"123",17,2020-04-21,"District of Columbia",965,3338,4303
"124",18,2020-04-28,"District of Columbia",1278,4101,5379
"125",19,2020-05-05,"District of Columbia",1219,5247,6466
"126",20,2020-05-12,"District of Columbia",881,6683,7564
"127",21,2020-05-19,"District of Columbia",955,2023,2978
"128",22,2020-05-26,"District of Columbia",109,1143,1252
"129",10,2020-03-03,"Florida",18,140,158
"130",11,2020-03-10,"Florida",123,544,667
"131",12,2020-03-17,"Florida",1030,10379,11409
"132",13,2020-03-24,"Florida",4302,37162,41464
"133",14,2020-03-31,"Florida",7851,61725,69576
"134",15,2020-04-07,"Florida",7277,65656,72933
"135",16,2020-04-14,"Florida",6059,63959,70018
"136",17,2020-04-21,"Florida",5478,84760,90238
"137",18,2020-04-28,"Florida",4759,83048,87807
"138",19,2020-05-05,"Florida",4085,112702,116787
"139",20,2020-05-12,"Florida",5460,109895,115355
"140",21,2020-05-19,"Florida",5304,226519,231823
"141",22,2020-05-26,"Florida",509,14480,14989
"142",10,2020-03-03,"Georgia",10,0,10
"143",11,2020-03-10,"Georgia",109,0,109
"144",12,2020-03-17,"Georgia",651,4297,4948
"145",13,2020-03-24,"Georgia",2037,5618,7655
"146",14,2020-03-31,"Georgia",4505,14045,18550
"147",15,2020-04-07,"Georgia",6001,19746,25747
"148",16,2020-04-14,"Georgia",5632,21675,27307
"149",17,2020-04-21,"Georgia",4966,37875,42841
"150",18,2020-04-28,"Georgia",5455,50701,56156
"151",19,2020-05-05,"Georgia",4559,63404,67963
"152",20,2020-05-12,"Georgia",4154,108847,113001
"153",21,2020-05-19,"Georgia",5263,143993,149256
"154",22,2020-05-26,"Georgia",386,1014,1400
"155",11,2020-03-10,"Guam",3,23,26
"156",12,2020-03-17,"Guam",26,138,164
"157",13,2020-03-24,"Guam",29,191,220
"158",14,2020-03-31,"Guam",55,153,208
"159",15,2020-04-07,"Guam",20,265,285
"160",16,2020-04-14,"Guam",0,221,221
"161",17,2020-04-21,"Guam",11,433,444
"162",18,2020-04-28,"Guam",5,1818,1823
"163",19,2020-05-05,"Guam",2,596,598
"164",20,2020-05-12,"Guam",3,731,734
"165",21,2020-05-19,"Guam",12,834,846
"166",22,2020-05-26,"Guam",3,112,115
"167",10,2020-03-03,"Hawaii",1,0,1
"168",11,2020-03-10,"Hawaii",5,0,5
"169",12,2020-03-17,"Hawaii",49,2955,3004
"170",13,2020-03-24,"Hawaii",119,4870,4989
"171",14,2020-03-31,"Hawaii",196,5330,5526
"172",15,2020-04-07,"Hawaii",128,5190,5318
"173",16,2020-04-14,"Hawaii",81,5250,5331
"174",17,2020-04-21,"Hawaii",26,4809,4835
"175",18,2020-04-28,"Hawaii",14,4842,4856
"176",19,2020-05-05,"Hawaii",12,3805,3817
"177",20,2020-05-12,"Hawaii",8,4354,4362
"178",21,2020-05-19,"Hawaii",3,8323,8326
"179",22,2020-05-26,"Hawaii",0,0,0
"180",10,2020-03-03,"Idaho",0,41,41
"181",11,2020-03-10,"Idaho",5,224,229
"182",12,2020-03-17,"Idaho",42,1044,1086
"183",13,2020-03-24,"Idaho",263,3087,3350
"184",14,2020-03-31,"Idaho",791,5498,6289
"185",15,2020-04-07,"Idaho",325,3561,3886
"186",16,2020-04-14,"Idaho",246,2318,2564
"187",17,2020-04-21,"Idaho",225,2354,2579
"188",18,2020-04-28,"Idaho",164,9619,9783
"189",19,2020-05-05,"Idaho",169,2166,2335
"190",20,2020-05-12,"Idaho",189,4341,4530
"191",21,2020-05-19,"Idaho",207,4527,4734
"192",22,2020-05-26,"Idaho",0,0,0
"193",10,2020-03-03,"Illinois",7,191,198
"194",11,2020-03-10,"Illinois",86,741,827
"195",12,2020-03-17,"Illinois",1180,7651,8831
"196",13,2020-03-24,"Illinois",3784,16806,20590
"197",14,2020-03-31,"Illinois",7205,25291,32496
"198",15,2020-04-07,"Illinois",9763,33063,42826
"199",16,2020-04-14,"Illinois",9483,33107,42590
"200",17,2020-04-21,"Illinois",14375,64895,79270
"201",18,2020-04-28,"Illinois",17957,87562,105519
"202",19,2020-05-05,"Illinois",15167,94111,109278
"203",20,2020-05-12,"Illinois",17478,143338,160816
"204",21,2020-05-19,"Illinois",15532,150791,166323
"205",22,2020-05-26,"Illinois",1178,16052,17230
"206",10,2020-03-03,"Indiana",1,0,1
"207",11,2020-03-10,"Indiana",22,115,137
"208",12,2020-03-17,"Indiana",235,1586,1821
"209",13,2020-03-24,"Indiana",1527,8171,9698
"210",14,2020-03-31,"Indiana",3158,11375,14533
"211",15,2020-04-07,"Indiana",3292,15056,18348
"212",16,2020-04-14,"Indiana",3450,16650,20100
"213",17,2020-04-21,"Indiana",4275,15562,19837
"214",18,2020-04-28,"Indiana",4546,24275,28821
"215",19,2020-05-05,"Indiana",4120,29271,33391
"216",20,2020-05-12,"Indiana",3628,33596,37224
"217",21,2020-05-19,"Indiana",3460,38879,42339
"218",22,2020-05-26,"Indiana",363,4135,4498
"219",10,2020-03-03,"Iowa",3,26,29
"220",11,2020-03-10,"Iowa",19,57,76
"221",12,2020-03-17,"Iowa",83,1960,2043
"222",13,2020-03-24,"Iowa",319,4119,4438
"223",14,2020-03-31,"Iowa",522,4491,5013
"224",15,2020-04-07,"Iowa",764,6333,7097
"225",16,2020-04-14,"Iowa",1449,5675,7124
"226",17,2020-04-21,"Iowa",2709,9621,12330
"227",18,2020-04-28,"Iowa",3835,15176,19011
"228",19,2020-05-05,"Iowa",2670,17961,20631
"229",20,2020-05-12,"Iowa",2582,22774,25356
"230",21,2020-05-19,"Iowa",2622,26945,29567
"231",22,2020-05-26,"Iowa",126,2163,2289
"232",10,2020-03-03,"Kansas",1,11,12
"233",11,2020-03-10,"Kansas",10,155,165
"234",12,2020-03-17,"Kansas",71,251,322
"235",13,2020-03-24,"Kansas",286,4137,4423
"236",14,2020-03-31,"Kansas",477,3685,4162
"237",15,2020-04-07,"Kansas",531,4249,4780
"238",16,2020-04-14,"Kansas",610,4287,4897
"239",17,2020-04-21,"Kansas",1342,7064,8406
"240",18,2020-04-28,"Kansas",1917,9519,11436
"241",19,2020-05-05,"Kansas",1871,13635,15506
"242",20,2020-05-12,"Kansas",1224,11657,12881
"243",21,2020-05-19,"Kansas",878,13531,14409
"244",22,2020-05-26,"Kansas",0,0,0
"245",10,2020-03-03,"Kentucky",4,17,21
"246",11,2020-03-10,"Kentucky",17,217,234
"247",12,2020-03-17,"Kentucky",83,1528,1611
"248",13,2020-03-24,"Kentucky",335,3817,4152
"249",14,2020-03-31,"Kentucky",516,12233,12749
"250",15,2020-04-07,"Kentucky",1008,6091,7099
"251",16,2020-04-14,"Kentucky",997,5709,6706
"252",17,2020-04-21,"Kentucky",1114,14788,15902
"253",18,2020-04-28,"Kentucky",1056,8879,9935
"254",19,2020-05-05,"Kentucky",1310,27204,28514
"255",20,2020-05-12,"Kentucky",1248,41514,42762
"256",21,2020-05-19,"Kentucky",883,39288,40171
"257",22,2020-05-26,"Kentucky",0,0,0
"258",10,2020-03-03,"Louisiana",1,5,6
"259",11,2020-03-10,"Louisiana",114,183,297
"260",12,2020-03-17,"Louisiana",1057,4588,5645
"261",13,2020-03-24,"Louisiana",2853,25232,28085
"262",14,2020-03-31,"Louisiana",10842,24291,35133
"263",15,2020-04-07,"Louisiana",6149,32776,38925
"264",16,2020-04-14,"Louisiana",3507,24513,28020
"265",17,2020-04-21,"Louisiana",2545,8333,10878
"266",18,2020-04-28,"Louisiana",2605,31337,33942
"267",19,2020-05-05,"Louisiana",2142,37757,39899
"268",20,2020-05-12,"Louisiana",2894,46024,48918
"269",21,2020-05-19,"Louisiana",3100,58050,61150
"270",22,2020-05-26,"Louisiana",245,9883,10128
"271",10,2020-03-03,"Maine",0,1,1
"272",11,2020-03-10,"Maine",17,763,780
"273",12,2020-03-17,"Maine",90,2027,2117
"274",13,2020-03-24,"Maine",168,603,771
"275",14,2020-03-31,"Maine",224,2694,2918
"276",15,2020-04-07,"Maine",199,5520,5719
"277",16,2020-04-14,"Maine",177,2468,2645
"278",17,2020-04-21,"Maine",148,2708,2856
"279",18,2020-04-28,"Maine",182,2762,2944
"280",19,2020-05-05,"Maine",257,2546,2803
"281",20,2020-05-12,"Maine",251,0,251
"282",21,2020-05-19,"Maine",361,13358,13719
"283",22,2020-05-26,"Maine",35,0,35
"284",10,2020-03-03,"Maryland",5,73,78
"285",11,2020-03-10,"Maryland",32,21,53
"286",12,2020-03-17,"Maryland",251,0,251
"287",13,2020-03-24,"Maryland",1125,13222,14347
"288",14,2020-03-31,"Maryland",2632,12256,14888
"289",15,2020-04-07,"Maryland",4891,17243,22134
"290",16,2020-04-14,"Maryland",4748,14898,19646
"291",17,2020-04-21,"Maryland",5803,27776,33579
"292",18,2020-04-28,"Maryland",6921,25098,32019
"293",19,2020-05-05,"Maryland",6965,20820,27785
"294",20,2020-05-12,"Maryland",6389,30337,36726
"295",21,2020-05-19,"Maryland",7390,40681,48071
"296",22,2020-05-26,"Maryland",535,4375,4910
"297",11,2020-03-10,"Massachusetts",89,1199,1288
"298",12,2020-03-17,"Massachusetts",581,7064,7645
"299",13,2020-03-24,"Massachusetts",4975,28903,33878
"300",14,2020-03-31,"Massachusetts",8086,25554,33640
"301",15,2020-04-07,"Massachusetts",13055,32780,45835
"302",16,2020-04-14,"Massachusetts",14622,40546,55168
"303",17,2020-04-21,"Massachusetts",15046,52379,67425
"304",18,2020-04-28,"Massachusetts",12625,66756,79381
"305",19,2020-05-05,"Massachusetts",9375,61085,70460
"306",20,2020-05-12,"Massachusetts",7548,58550,66098
"307",21,2020-05-19,"Massachusetts",7261,72474,79735
"308",22,2020-05-26,"Massachusetts",422,4498,4920
"309",9,2020-02-25,"Michigan",9,0,9
"310",10,2020-03-03,"Michigan",236,36,272
"311",11,2020-03-10,"Michigan",1679,236,1915
"312",12,2020-03-17,"Michigan",3856,4425,8281
"313",13,2020-03-24,"Michigan",5112,16486,21598
"314",14,2020-03-31,"Michigan",7949,21937,29886
"315",15,2020-04-07,"Michigan",6785,13889,20674
"316",16,2020-04-14,"Michigan",6365,24789,31154
"317",17,2020-04-21,"Michigan",6210,37752,43962
"318",18,2020-04-28,"Michigan",5740,58889,64629
"319",19,2020-05-05,"Michigan",3602,72957,76559
"320",20,2020-05-12,"Michigan",4363,106867,111230
"321",21,2020-05-19,"Michigan",2966,59716,62682
"322",22,2020-05-26,"Michigan",223,11196,11419
"323",10,2020-03-03,"Minnesota",2,80,82
"324",11,2020-03-10,"Minnesota",52,1759,1811
"325",12,2020-03-17,"Minnesota",181,2672,2853
"326",13,2020-03-24,"Minnesota",341,13735,14076
"327",14,2020-03-31,"Minnesota",410,8896,9306
"328",15,2020-04-07,"Minnesota",664,9635,10299
"329",16,2020-04-14,"Minnesota",820,7603,8423
"330",17,2020-04-21,"Minnesota",1346,13072,14418
"331",18,2020-04-28,"Minnesota",3418,21255,24673
"332",19,2020-05-05,"Minnesota",4565,25275,29840
"333",20,2020-05-12,"Minnesota",4573,36252,40825
"334",21,2020-05-19,"Minnesota",4943,42510,47453
"335",22,2020-05-26,"Minnesota",645,5194,5839
"336",10,2020-03-03,"Mississippi",0,0,0
"337",11,2020-03-10,"Mississippi",12,277,289
"338",12,2020-03-17,"Mississippi",237,866,1103
"339",13,2020-03-24,"Mississippi",598,1846,2444
"340",14,2020-03-31,"Mississippi",891,15643,16534
"341",15,2020-04-07,"Mississippi",1204,9410,10614
"342",16,2020-04-14,"Mississippi",1570,18880,20450
"343",17,2020-04-21,"Mississippi",1582,10446,12028
"344",18,2020-04-28,"Mississippi",1783,14432,16215
"345",19,2020-05-05,"Mississippi",1797,14411,16208
"346",20,2020-05-12,"Mississippi",1758,18124,19882
"347",21,2020-05-19,"Mississippi",2026,26124,28150
"348",22,2020-05-26,"Mississippi",273,3629,3902
"349",10,2020-03-03,"Missouri",1,0,1
"350",11,2020-03-10,"Missouri",5,164,169
"351",12,2020-03-17,"Missouri",177,205,382
"352",13,2020-03-24,"Missouri",848,12835,13683
"353",14,2020-03-31,"Missouri",1691,13909,15600
"354",15,2020-04-07,"Missouri",1666,13927,15593
"355",16,2020-04-14,"Missouri",1419,9166,10585
"356",17,2020-04-21,"Missouri",1364,13729,15093
"357",18,2020-04-28,"Missouri",1583,18762,20345
"358",19,2020-05-05,"Missouri",1164,23005,24169
"359",20,2020-05-12,"Missouri",1027,34691,35718
"360",21,2020-05-19,"Missouri",1222,4825,6047
"361",22,2020-05-26,"Missouri",124,2789,2913
"362",10,2020-03-03,"Montana",0,11,11
"363",11,2020-03-10,"Montana",7,187,194
"364",12,2020-03-17,"Montana",27,948,975
"365",13,2020-03-24,"Montana",137,2997,3134
"366",14,2020-03-31,"Montana",128,2348,2476
"367",15,2020-04-07,"Montana",95,2213,2308
"368",16,2020-04-14,"Montana",39,1914,1953
"369",17,2020-04-21,"Montana",16,1966,1982
"370",18,2020-04-28,"Montana",8,2047,2055
"371",19,2020-05-05,"Montana",2,7482,7484
"372",20,2020-05-12,"Montana",11,5584,5595
"373",21,2020-05-19,"Montana",9,5506,5515
"374",22,2020-05-26,"Montana",0,152,152
"375",10,2020-03-03,"Nebraska",3,36,39
"376",11,2020-03-10,"Nebraska",15,134,149
"377",12,2020-03-17,"Nebraska",32,186,218
"378",13,2020-03-24,"Nebraska",95,2228,2323
"379",14,2020-03-31,"Nebraska",264,3794,4058
"380",15,2020-04-07,"Nebraska",405,3780,4185
"381",16,2020-04-14,"Nebraska",660,4048,4708
"382",17,2020-04-21,"Nebraska",1554,5129,6683
"383",18,2020-04-28,"Nebraska",2882,8509,11391
"384",19,2020-05-05,"Nebraska",2405,10080,12485
"385",20,2020-05-12,"Nebraska",2033,19229,21262
"386",21,2020-05-19,"Nebraska",1786,16445,18231
"387",22,2020-05-26,"Nebraska",221,2089,2310
"388",10,2020-03-03,"Nevada",1,14,15
"389",11,2020-03-10,"Nevada",44,154,198
"390",12,2020-03-17,"Nevada",200,3322,3522
"391",13,2020-03-24,"Nevada",763,6717,7480
"392",14,2020-03-31,"Nevada",945,5469,6414
"393",15,2020-04-07,"Nevada",1018,6817,7835
"394",16,2020-04-14,"Nevada",859,6024,6883
"395",17,2020-04-21,"Nevada",860,5606,6466
"396",18,2020-04-28,"Nevada",801,6552,7353
"397",19,2020-05-05,"Nevada",661,13257,13918
"398",20,2020-05-12,"Nevada",754,20994,21748
"399",21,2020-05-19,"Nevada",973,31926,32899
"400",22,2020-05-26,"Nevada",118,8518,8636
"401",10,2020-03-03,"New Hampshire",4,38,42
"402",11,2020-03-10,"New Hampshire",9,233,242
"403",12,2020-03-17,"New Hampshire",65,1103,1168
"404",13,2020-03-24,"New Hampshire",236,4012,4248
"405",14,2020-03-31,"New Hampshire",355,2315,2670
"406",15,2020-04-07,"New Hampshire",316,2521,2837
"407",16,2020-04-14,"New Hampshire",407,2504,2911
"408",17,2020-04-21,"New Hampshire",472,5134,5606
"409",18,2020-04-28,"New Hampshire",724,6422,7146
"410",19,2020-05-05,"New Hampshire",572,7441,8013
"411",20,2020-05-12,"New Hampshire",436,9559,9995
"412",21,2020-05-19,"New Hampshire",553,15955,16508
"413",22,2020-05-26,"New Hampshire",48,1605,1653
"414",10,2020-03-03,"New Jersey",10,35,45
"415",11,2020-03-10,"New Jersey",167,85,252
"416",12,2020-03-17,"New Jersey",2666,239,2905
"417",13,2020-03-24,"New Jersey",13792,24865,38657
"418",14,2020-03-31,"New Jersey",24454,22718,47172
"419",15,2020-04-07,"New Jersey",23494,16943,40437
"420",16,2020-04-14,"New Jersey",24222,24366,48588
"421",17,2020-04-21,"New Jersey",22382,27336,49718
"422",18,2020-04-28,"New Jersey",17081,32364,49445
"423",19,2020-05-05,"New Jersey",11676,137037,148713
"424",20,2020-05-12,"New Jersey",8094,71542,79636
"425",21,2020-05-19,"New Jersey",7053,111175,118228
"426",22,2020-05-26,"New Jersey",672,11423,12095
"427",10,2020-03-03,"New Mexico",0,57,57
"428",11,2020-03-10,"New Mexico",17,509,526
"429",12,2020-03-17,"New Mexico",48,4755,4803
"430",13,2020-03-24,"New Mexico",172,5621,5793
"431",14,2020-03-31,"New Mexico",387,7570,7957
"432",15,2020-04-07,"New Mexico",621,10758,11379
"433",16,2020-04-14,"New Mexico",600,5927,6527
"434",17,2020-04-21,"New Mexico",881,18692,19573
"435",18,2020-04-28,"New Mexico",1124,20238,21362
"436",19,2020-05-05,"New Mexico",1013,23508,24521
"437",20,2020-05-12,"New Mexico",1075,29680,30755
"438",21,2020-05-19,"New Mexico",1005,39223,40228
"439",22,2020-05-26,"New Mexico",83,3797,3880
"440",10,2020-03-03,"New York",142,92,234
"441",11,2020-03-10,"New York",808,4451,5259
"442",12,2020-03-17,"New York",19925,52871,72796
"443",13,2020-03-24,"New York",45622,62557,108179
"444",14,2020-03-31,"New York",64192,70151,134343
"445",15,2020-04-07,"New York",64342,93204,157546
"446",16,2020-04-14,"New York",52481,103023,155504
"447",17,2020-04-21,"New York",44484,147750,192234
"448",18,2020-04-28,"New York",26957,154258,181215
"449",19,2020-05-05,"New York",18102,179239,197341
"450",20,2020-05-12,"New York",14316,220590,234906
"451",21,2020-05-19,"New York",11393,288499,299892
"452",22,2020-05-26,"New York",1072,33607,34679
"453",10,2020-03-03,"North Carolina",1,0,1
"454",11,2020-03-10,"North Carolina",31,296,327
"455",12,2020-03-17,"North Carolina",264,7845,8109
"456",13,2020-03-24,"North Carolina",1010,11416,12426
"457",14,2020-03-31,"North Carolina",1563,18299,19862
"458",15,2020-04-07,"North Carolina",1946,20716,22662
"459",16,2020-04-14,"North Carolina",1948,14148,16096
"460",17,2020-04-21,"North Carolina",2378,28058,30436
"461",18,2020-04-28,"North Carolina",2706,33813,36519
"462",19,2020-05-05,"North Carolina",3197,46229,49426
"463",20,2020-05-12,"North Carolina",3978,55912,59890
"464",21,2020-05-19,"North Carolina",4941,83994,88935
"465",22,2020-05-26,"North Carolina",176,7465,7641
"466",10,2020-03-03,"North Dakota",0,0,0
"467",11,2020-03-10,"North Dakota",1,123,124
"468",12,2020-03-17,"North Dakota",29,1230,1259
"469",13,2020-03-24,"North Dakota",79,2375,2454
"470",14,2020-03-31,"North Dakota",116,3260,3376
"471",15,2020-04-07,"North Dakota",106,3462,3568
"472",16,2020-04-14,"North Dakota",296,3670,3966
"473",17,2020-04-21,"North Dakota",315,7372,7687
"474",18,2020-04-28,"North Dakota",283,12037,12320
"475",19,2020-05-05,"North Dakota",293,11967,12260
"476",20,2020-05-12,"North Dakota",413,9134,9547
"477",21,2020-05-19,"North Dakota",526,9263,9789
"478",22,2020-05-26,"North Dakota",-35,539,504
"479",12,2020-03-17,"Northern Mariana Islands",0,0,0
"480",13,2020-03-24,"Northern Mariana Islands",2,0,2
"481",14,2020-03-31,"Northern Mariana Islands",6,13,19
"482",15,2020-04-07,"Northern Mariana Islands",3,14,17
"483",16,2020-04-14,"Northern Mariana Islands",3,24,27
"484",17,2020-04-21,"Northern Mariana Islands",0,0,0
"485",18,2020-04-28,"Northern Mariana Islands",0,1270,1270
"486",19,2020-05-05,"Northern Mariana Islands",5,1355,1360
"487",20,2020-05-12,"Northern Mariana Islands",2,723,725
"488",21,2020-05-19,"Northern Mariana Islands",1,1336,1337
"489",22,2020-05-26,"Northern Mariana Islands",0,183,183
"490",10,2020-03-03,"Ohio",3,11,14
"491",11,2020-03-10,"Ohio",47,129,176
"492",12,2020-03-17,"Ohio",392,0,392
"493",13,2020-03-24,"Ohio",1491,25202,26693
"494",14,2020-03-31,"Ohio",2517,18586,21103
"495",15,2020-04-07,"Ohio",2525,14209,16734
"496",16,2020-04-14,"Ohio",5944,19783,25727
"497",17,2020-04-21,"Ohio",2780,25772,28552
"498",18,2020-04-28,"Ohio",4775,30989,35764
"499",19,2020-05-05,"Ohio",4303,51072,55375
"500",20,2020-05-12,"Ohio",3677,57642,61319
"501",21,2020-05-19,"Ohio",4023,54462,58485
"502",22,2020-05-26,"Ohio",529,8537,9066
"503",10,2020-03-03,"Oklahoma",0,8,8
"504",11,2020-03-10,"Oklahoma",9,166,175
"505",12,2020-03-17,"Oklahoma",71,520,591
"506",13,2020-03-24,"Oklahoma",400,513,913
"507",14,2020-03-31,"Oklahoma",846,215,1061
"508",15,2020-04-07,"Oklahoma",742,19368,20110
"509",16,2020-04-14,"Oklahoma",611,12176,12787
"510",17,2020-04-21,"Oklahoma",600,16925,17525
"511",18,2020-04-28,"Oklahoma",764,9913,10677
"512",19,2020-05-05,"Oklahoma",569,31575,32144
"513",20,2020-05-12,"Oklahoma",785,26783,27568
"514",21,2020-05-19,"Oklahoma",692,36781,37473
"515",22,2020-05-26,"Oklahoma",47,-1139,-1092
"516",10,2020-03-03,"Oregon",14,165,179
"517",11,2020-03-10,"Oregon",25,414,439
"518",12,2020-03-17,"Oregon",152,3070,3222
"519",13,2020-03-24,"Oregon",415,8628,9043
"520",14,2020-03-31,"Oregon",526,8392,8918
"521",15,2020-04-07,"Oregon",452,8868,9320
"522",16,2020-04-14,"Oregon",372,8552,8924
"523",17,2020-04-21,"Oregon",398,10755,11153
"524",18,2020-04-28,"Oregon",405,11854,12259
"525",19,2020-05-05,"Oregon",527,13622,14149
"526",20,2020-05-12,"Oregon",401,19308,19709
"527",21,2020-05-19,"Oregon",262,16281,16543
"528",22,2020-05-26,"Oregon",18,1662,1680
"529",10,2020-03-03,"Pennsylvania",8,0,8
"530",11,2020-03-10,"Pennsylvania",66,670,736
"531",12,2020-03-17,"Pennsylvania",568,5925,6493
"532",13,2020-03-24,"Pennsylvania",3443,27182,30625
"533",14,2020-03-31,"Pennsylvania",8893,37097,45990
"534",15,2020-04-07,"Pennsylvania",11219,34719,45938
"535",16,2020-04-14,"Pennsylvania",9033,24127,33160
"536",17,2020-04-21,"Pennsylvania",8818,31652,40470
"537",18,2020-04-28,"Pennsylvania",8042,34126,42168
"538",19,2020-05-05,"Pennsylvania",7062,36206,43268
"539",20,2020-05-12,"Pennsylvania",5902,45849,51751
"540",21,2020-05-19,"Pennsylvania",5130,57375,62505
"541",22,2020-05-26,"Pennsylvania",451,4907,5358
"542",11,2020-03-10,"Puerto Rico",5,9,14
"543",12,2020-03-17,"Puerto Rico",26,180,206
"544",13,2020-03-24,"Puerto Rico",143,742,885
"545",14,2020-03-31,"Puerto Rico",339,2501,2840
"546",15,2020-04-07,"Puerto Rico",390,2528,2918
"547",16,2020-04-14,"Puerto Rico",349,2526,2875
"548",17,2020-04-21,"Puerto Rico",137,827,964
"549",18,2020-04-28,"Puerto Rico",454,0,454
"550",19,2020-05-05,"Puerto Rico",413,0,-8900
"551",20,2020-05-12,"Puerto Rico",454,0,454
"552",21,2020-05-19,"Puerto Rico",550,0,550
"553",22,2020-05-26,"Puerto Rico",64,0,64
"554",9,2020-02-25,"Rhode Island",0,0,0
"555",10,2020-03-03,"Rhode Island",2,30,32
"556",11,2020-03-10,"Rhode Island",18,278,296
"557",12,2020-03-17,"Rhode Island",85,835,920
"558",13,2020-03-24,"Rhode Island",296,2044,2340
"559",14,2020-03-31,"Rhode Island",680,4212,4892
"560",15,2020-04-07,"Rhode Island",1894,10286,12180
"561",16,2020-04-14,"Rhode Island",2122,14305,16427
"562",17,2020-04-21,"Rhode Island",2610,16187,18797
"563",18,2020-04-28,"Rhode Island",1944,16307,18251
"564",19,2020-05-05,"Rhode Island",1798,17398,19196
"565",20,2020-05-12,"Rhode Island",1345,20707,22052
"566",21,2020-05-19,"Rhode Island",1270,16047,17317
"567",22,2020-05-26,"Rhode Island",145,2517,2662
"568",10,2020-03-03,"South Carolina",7,24,31
"569",11,2020-03-10,"South Carolina",21,211,232
"570",12,2020-03-17,"South Carolina",270,1231,1501
"571",13,2020-03-24,"South Carolina",627,2694,3321
"572",14,2020-03-31,"South Carolina",1124,12767,13891
"573",15,2020-04-07,"South Carolina",1270,11179,12449
"574",16,2020-04-14,"South Carolina",1058,7997,9055
"575",17,2020-04-21,"South Carolina",1113,9168,10281
"576",18,2020-04-28,"South Carolina",1136,12291,13427
"577",19,2020-05-05,"South Carolina",1027,19242,20269
"578",20,2020-05-12,"South Carolina",1289,45813,47102
"579",21,2020-05-19,"South Carolina",1236,33225,34461
"580",22,2020-05-26,"South Carolina",238,6476,6714
"581",10,2020-03-03,"South Dakota",0,5,5
"582",11,2020-03-10,"South Dakota",10,489,499
"583",12,2020-03-17,"South Dakota",18,268,286
"584",13,2020-03-24,"South Dakota",73,2716,2789
"585",14,2020-03-31,"South Dakota",187,2254,2441
"586",15,2020-04-07,"South Dakota",580,2402,2982
"587",16,2020-04-14,"South Dakota",817,2507,3324
"588",17,2020-04-21,"South Dakota",560,3489,4049
"589",18,2020-04-28,"South Dakota",423,1915,2338
"590",19,2020-05-05,"South Dakota",946,4919,5865
"591",20,2020-05-12,"South Dakota",413,4054,4467
"592",21,2020-05-19,"South Dakota",559,5679,6238
"593",22,2020-05-26,"South Dakota",67,1688,1755
"594",10,2020-03-03,"Tennessee",2,0,2
"595",11,2020-03-10,"Tennessee",49,270,319
"596",12,2020-03-17,"Tennessee",563,3002,3565
"597",13,2020-03-24,"Tennessee",1219,18198,19417
"598",14,2020-03-31,"Tennessee",1968,22078,24046
"599",15,2020-04-07,"Tennessee",1808,27037,28845
"600",16,2020-04-14,"Tennessee",1628,22866,24494
"601",17,2020-04-21,"Tennessee",2680,51033,53713
"602",18,2020-04-28,"Tennessee",3653,53388,57041
"603",19,2020-05-05,"Tennessee",1973,59861,61834
"604",20,2020-05-12,"Tennessee",2467,61684,64151
"605",21,2020-05-19,"Tennessee",2596,56195,58791
"606",22,2020-05-26,"Tennessee",358,6927,7285
"607",10,2020-03-03,"Texas",11,0,11
"608",11,2020-03-10,"Texas",45,0,45
"609",12,2020-03-17,"Texas",295,9703,9998
"610",13,2020-03-24,"Texas",2525,23300,25825
"611",14,2020-03-31,"Texas",4399,45078,49477
"612",15,2020-04-07,"Texas",6630,41239,47869
"613",16,2020-04-14,"Texas",5552,51616,57168
"614",17,2020-04-21,"Texas",5839,94284,100123
"615",18,2020-04-28,"Texas",7035,109846,116881
"616",19,2020-05-05,"Texas",7537,110762,118299
"617",20,2020-05-12,"Texas",8824,145324,154148
"618",21,2020-05-19,"Texas",7278,118531,125809
"619",22,2020-05-26,"Texas",589,14990,15579
"620",12,2020-03-17,"US Virgin Islands",16,0,16
"621",13,2020-03-24,"US Virgin Islands",13,126,139
"622",14,2020-03-31,"US Virgin Islands",13,96,109
"623",15,2020-04-07,"US Virgin Islands",8,100,108
"624",16,2020-04-14,"US Virgin Islands",2,232,234
"625",17,2020-04-21,"US Virgin Islands",6,162,168
"626",18,2020-04-28,"US Virgin Islands",7,249,256
"627",19,2020-05-05,"US Virgin Islands",3,145,148
"628",20,2020-05-12,"US Virgin Islands",0,168,168
"629",21,2020-05-19,"US Virgin Islands",0,65,65
"630",22,2020-05-26,"US Virgin Islands",0,82,82
"631",10,2020-03-03,"Utah",0,0,0
"632",11,2020-03-10,"Utah",38,131,169
"633",12,2020-03-17,"Utah",218,4659,4877
"634",13,2020-03-24,"Utah",549,10407,10956
"635",14,2020-03-31,"Utah",869,16522,17391
"636",15,2020-04-07,"Utah",688,11705,12393
"637",16,2020-04-14,"Utah",850,21674,22524
"638",17,2020-04-21,"Utah",1020,30864,31884
"639",18,2020-04-28,"Utah",1084,23382,24466
"640",19,2020-05-05,"Utah",1045,24879,25924
"641",20,2020-05-12,"Utah",1022,22415,23437
"642",21,2020-05-19,"Utah",1137,21309,22446
"643",22,2020-05-26,"Utah",99,2025,2124
"644",10,2020-03-03,"Vermont",1,36,37
"645",11,2020-03-10,"Vermont",16,451,467
"646",12,2020-03-17,"Vermont",80,937,1017
"647",13,2020-03-24,"Vermont",196,2294,2490
"648",14,2020-03-31,"Vermont",282,2443,2725
"649",15,2020-04-07,"Vermont",186,3114,3300
"650",16,2020-04-14,"Vermont",59,2396,2455
"651",17,2020-04-21,"Vermont",42,2148,2190
"652",18,2020-04-28,"Vermont",44,2070,2114
"653",19,2020-05-05,"Vermont",21,2908,2929
"654",20,2020-05-12,"Vermont",17,4750,4767
"655",21,2020-05-19,"Vermont",18,5160,5178
"656",22,2020-05-26,"Vermont",5,749,754
"657",10,2020-03-03,"Virginia",3,38,41
"658",11,2020-03-10,"Virginia",48,400,448
"659",12,2020-03-17,"Virginia",203,3005,3208
"660",13,2020-03-24,"Virginia",766,7575,8341
"661",14,2020-03-31,"Virginia",1858,10625,12483
"662",15,2020-04-07,"Virginia",2869,14011,16880
"663",16,2020-04-14,"Virginia",3243,12091,15334
"664",17,2020-04-21,"Virginia",4545,19399,23944
"665",18,2020-04-28,"Virginia",5957,25657,31614
"666",19,2020-05-05,"Virginia",5578,32746,38324
"667",20,2020-05-12,"Virginia",6070,39539,45609
"668",21,2020-05-19,"Virginia",6587,55937,62524
"669",22,2020-05-26,"Virginia",1615,6816,8431
"670",4,2020-01-21,"Washington",0,0,0
"671",5,2020-01-28,"Washington",0,0,0
"672",6,2020-02-04,"Washington",1,0,1
"673",7,2020-02-11,"Washington",0,0,0
"674",8,2020-02-18,"Washington",0,0,0
"675",9,2020-02-25,"Washington",63,229,292
"676",10,2020-03-03,"Washington",313,2944,3257
"677",11,2020-03-10,"Washington",1199,19784,20983
"678",12,2020-03-17,"Washington",2027,25551,27578
"679",13,2020-03-24,"Washington",2837,25737,28574
"680",14,2020-03-31,"Washington",2496,25958,28454
"681",15,2020-04-07,"Washington",2006,23902,25908
"682",16,2020-04-14,"Washington",1844,23558,25402
"683",17,2020-04-21,"Washington",1770,32813,34583
"684",18,2020-04-28,"Washington",1705,34615,36320
"685",19,2020-05-05,"Washington",1466,32858,34324
"686",20,2020-05-12,"Washington",1291,32290,33581
"687",21,2020-05-19,"Washington",809,26526,27335
"688",22,2020-05-26,"Washington",237,3768,4005
"689",10,2020-03-03,"West Virginia",0,2,2
"690",11,2020-03-10,"West Virginia",0,78,78
"691",12,2020-03-17,"West Virginia",16,364,380
"692",13,2020-03-24,"West Virginia",110,2540,2650
"693",14,2020-03-31,"West Virginia",219,6611,6830
"694",15,2020-04-07,"West Virginia",281,6434,6715
"695",16,2020-04-14,"West Virginia",276,5224,5500
"696",17,2020-04-21,"West Virginia",161,20723,20884
"697",18,2020-04-28,"West Virginia",143,10057,10200
"698",19,2020-05-05,"West Virginia",160,10070,10230
"699",20,2020-05-12,"West Virginia",125,12441,12566
"700",21,2020-05-19,"West Virginia",283,10007,10290
"701",22,2020-05-26,"West Virginia",80,1406,1486
"702",10,2020-03-03,"Wisconsin",1,36,37
"703",11,2020-03-10,"Wisconsin",46,468,514
"704",12,2020-03-17,"Wisconsin",369,6546,6915
"705",13,2020-03-24,"Wisconsin",805,8806,9611
"706",14,2020-03-31,"Wisconsin",1219,10718,11937
"707",15,2020-04-07,"Wisconsin",988,10195,11183
"708",16,2020-04-14,"Wisconsin",1071,9834,10905
"709",17,2020-04-21,"Wisconsin",1582,14708,16290
"710",18,2020-04-28,"Wisconsin",2155,19156,21311
"711",19,2020-05-05,"Wisconsin",2182,27566,29748
"712",20,2020-05-12,"Wisconsin",2269,36469,38738
"713",21,2020-05-19,"Wisconsin",2897,48877,51774
"714",22,2020-05-26,"Wisconsin",279,7495,7774
"715",10,2020-03-03,"Wyoming",0,0,0
"716",11,2020-03-10,"Wyoming",3,0,3
"717",12,2020-03-17,"Wyoming",23,592,615
"718",13,2020-03-24,"Wyoming",68,1248,1316
"719",14,2020-03-31,"Wyoming",116,1879,1995
"720",15,2020-04-07,"Wyoming",65,1970,2035
"721",16,2020-04-14,"Wyoming",38,1384,1422
"722",17,2020-04-21,"Wyoming",57,724,781
"723",18,2020-04-28,"Wyoming",216,2071,2287
"724",19,2020-05-05,"Wyoming",76,1535,1611
"725",20,2020-05-12,"Wyoming",92,4928,5020
"726",21,2020-05-19,"Wyoming",84,3220,3304
"727",22,2020-05-26,"Wyoming",12,1101,1113
